3113131113113131131111131111212
2301023102212223223303003123102
2313022112322202200213110210312
2022323122220112311102111113102
3102020220031322231123111121022
2313123112302200213022131211122
2020222301030231102223022103222
2312202131121121312122123112022
2221111223033022222201102321122
2212312230202310220311110211222
2322222021110103031213311031022
2221021301311310112302022302302
2211112213032111120211102211232
2103102122101131231111112130222
3112311231131022202111311222222
2122103022221122111112022221222
3021302102111211231221121232222
2311031111123110222111230202202
2231111310302311123130021302102
2031030030210123202231110231112
2301113111113002102203031023212
2311102313103111230310121300122
2033030230310312303111112111102
3102323001303010230311121131322
3022221312030131023023123022222
2230212221111203022310202102022
2223022011130311220211123111102
2102301313021032303112222311112
2310213021111202012321022212122
2223102312312111310211302113022
2121122021021130231011031122322
3031221113111221231131211220202
2302031302232212221222132211232
0213101030220322203023220023022
2222313311212022212302211110302
2102222222103102230230311131022
3112022021122310102212012210302
2111102311022131312323112131312
2111312231123202022022321202022
3110021021100111121100210111102
1111111111111111111111111111110
