3111113113111111133131113111112
2321230221103113002202112123122
2012221223110322310331103020212
3030223030311022213021122113122
2122302103111023122211231122122
3021213111023102202122203202222
3110303103122130311102310113022
2231030110223203012310110320222
2223311111220113112131311031022
2122021312211120321202121123102
3022112122233031010111023202312
2102312222202301311311120112022
2311022222112313030213030312302
2031303021122020303102121221212
3102230303021213230211130232222
2111022232112300212131203220102
2311110223102213103210110211112
2112303022130302310112311121302
3123030301221112211110231213022
2120322211031122231111221302302
3013002113102120230313030230232
2110111122311211221222121010202
2311311302232130230221211131122
0312212022221021221212111022102
2020123112221130222303311121132
3113020120213222210230032211222
2222131112122221112223102111022
2223021121102211210221221311122
2210311231312112112212232123222
2111030202022111101102021002002
1111111111101111111111111111110
