3111331113110311131131111311112
3030203022302221212302310213212
2301212302230230320230213100302
2130302310223021223021112113022
3021212011210112202111301122112
2312313111123112311031231101122
2212220311222122013102201311222
2220211030213023130312113032102
2112312123102120223103120321122
2302021102113031203030213023202
2231311111120310110303020302112
3022021111111212312232231030122
2311111121310222223002103131022
2033111212223021020311120203102
2300130122230313123031213112312
2111103103021030210302122210302
3111122130111223111103022311212
3031103223130223123023102102222
2103110220302222230302311312122
2310223030232220223110221021022
2131030303020213022131231131102
3023123230231102101212010211102
2122222023023113130321131113122
3220221122122122303031212120222
2211231023223022230210302213102
2112021302022322222310212122312
3101232123122200212231123020302
2312223020202131122203221312222
2021002303112202120330012222022
2311130212302313013001312223110
3031203121212222112331022220312
2310111212120231102021300231122
2123112211212023101212311022202
3022110102323023111122031110302
2301111112022322312223123311212
2311131121222020030222202032302
2213203212121231223222310302232
2122112122210102122022112102202
2203020223131111202121303302102
2110311020201112111110030011112
1111111111111111111111111111110
