311311113312331131131113131113111132
302103122222222210231222221321122202
231231202022202133022020210211210302
221022121302123020301113113023111032
221121212023210303123121221222311302
213110123102111230222230230302102102
222113103120310203210203023021131122
220310312231031110311110220311122222
311213022211203130213311211031202122
212102320312310231102221131112111202
303110213020233023112213223020311112
230311012111002122220122202131033022
223111121111131021211122131021302112
222311223111021130213021021110221122
220302210313011221230211231211031022
211023112223131212121231222311131122
312230230220202023222222022033023222
220223203223131122222103103102302222
211102110210231020211112130130212222
231310311111221110111303023203022222
212021031223021131112210302112122222
323112102230312303103111211222302202
222303130221021032122112112120212122
222212211211111301211122123023102122
200300310110310030121101210110310202
011111111111111111111111111111111110
