3111311311131311313113113111112
2231032033022022021022121103102
3021103102301123113121213130312
2131100312031103102210222221102
2203130221303110302311102213122
2312212232232223110223110322222
3020321022220210111230311022222
2131211122231231130021310220212
2202121202022223221310231211122
2131222131222102031031021111022
3102023022023112303101311213122
2131122103122122030310230300222
2201211122221123123030223031102
2131121230211020202113022121112
3103213022311131111302121213102
2310322121011203130222310322132
2302021013111110203210231003202
2212311121131113110231021130302
2223011211023110321021313021212
2120311231202331011130220310122
2223212122310203031223211303022
3022123022031032302302110032122
2320302223112102230031123120302
2203030222221112211103212211032
2310321102233120113112120311102
2233013111020211102321211112212
2022221103121113110212223121222
2302231110131122311020223030302
2210211111221202231111302223022
2211111312210110211122030222122
2231132022111131311221122221222
2103221101131022230211022212222
3310211111221302122131130230222
2230311130212031221210202303012
2021031223031212222123112211102
2113302021302322211212323111100
3102211112032202310222022331112
2330113121120210231223020202112
2202321212121111022022311231302
2110210101211111101120102102022
1111111111111111111011111111110
