3113113111113113131111111131112
2321220130321021221311223003102
2230231103013110210230221310312
2201103103120131031021212112212
2112313110213211302312321122102
3103022111302110211022211021302
0110303112211112111102123112122
2311222120331103113113023031222
2122213031021112221302322302222
3010120110311302212030222212212
2131311303030212321103022030302
3022032230321122231110222302222
1103102123031202203113022213022
2312111021202112121022122122112
3022313122121121231231223023102
2302120203031230202222223122302
2131021112102121112122200202212
2203111112131231123022133102112
2311103103122021222103020313122
2211130110221112221112312020302
2111213311211220222230221231022
3312222030310231030221032221322
2020221121011303103231102122202
2111311211312230230231021222112
3312032110222031212023110221302
2023103111101122102102311231022
2122320211311003131031032021302
3102211130311110211123103102122
2110212123013121131022121131212
2311111020330213103102231222102
2112313031223120302311022003112
3120212122022103130231131310302
2211301203021312221221202031022
2322032312112020212203111121122
2223120221121131120230331223212
2022201031213022111223022020302
3222331102310311032102303112212
2222021112031021301310211120302
2021111123112310230212131231022
2111112100301031011102102003102
1111111111111111111111111111110
