311011331111113111112
211112021313021123122
213123110222311020222
300222311102112321212
213102113023122223102
310303300300222202322
231210231131122230222
221103021203202303002
211110112310112223112
231131230303110230302
230222221212111221222
203222110223112203022
310021131120122130302
213131203211121203232
322222110311212130202
222213032121302202102
202120301010211123112
211023131310131023022
231312202311103122322
221020310031110100202
111111111111111101110
