3113111113111311311311111131112
2300311120330212012230311223022
2213031233021113112221032102112
2112302220231122300231103111222
2122102231201200311211102112122
3021310222111311032313103123022
2312031203112031102022311021222
2103102112301103131302103230222
3121131220211122202211310023022
2211202112131222312212013102122
2121113103022030222121310311222
3111022311102303103023031312002
2311110031131232210130222021132
2213311303002020311203023111222
2102030231111123032310122312222
2113102203131210302231100221022
3302312312102111102121131031102
2230302222113123113011221301320
2203030221102222300310212112022
2131021211310222123131031123122
2222310312233021210223123202222
2202211120222310313022222310202
2132131221222221022100302221302
3021022211022211301313030012232
2112103111320330231022323130202
3121122322221223021320200223102
2221210022012202130213031123122
2211211302310231023010123002222
2312111030211103221113021302212
2121313123111112211322112310122
3022102202311020130221310213302
2303122111031313021210211302212
2220211111102022330311232230122
2231131111231102021121022223102
2103203132222311031221122002302
2130112222221211102231223112212
3230302202122103111202202302312
2223030231031212112132122122222
2222112222302111030201211022022
2003100221011111121111111101102
1111111111111111111111111011110
