3111111311133111111311311311312
2111231030202303130222122122222
3312203121322230203221203222022
2022112212202212132032312021302
2321101022110123020302022111212
2213131113111302301021303110302
2230203122112032113103031121222
2223310221303101121130223232212
2022023112031122311021100220222
3122120321112222213101131221102
2203011021320221121111222031122
2111111310213023211312103123202
2311110211220300211021310220312
2211331012312131111110211212022
2312223112223022311311112321102
3020222122022303032012122211112
2331001221222030301331030303122
2201131232123103030021221030302
2311102023020110303112111112212
2233131102301311122301111020302
2020202322130231022113111323032
2111310203023023121320130202302
3112230310310120212031121122302
2122221211231231223023023030222
2210211112022103023102110223022
2311111301323112122131111223022
2031110030022131021223112120300
3111131111221201310222301211032
2113221312112131231022231113102
3122210301121202221102202303022
2222111031123112212131122122112
2102303021202320303212211022122
2132230312122211030102131103102
3020221221212112303131221310320
2123030212121122120202230303202
3210303130213022231130023012232
2311210221122102203211323102022
2022311211221310110310222312102
2122221312030313131213022301122
3021012021101020202102200211102
1111111111111111111111111111110
