3111111131111131311131111111312
2311303021113022033023123122212
2102230311222303120302210202220
3312221030222231021112311112122
2022213121302022113120211111202
2120322230231112210211231112102
3231022203023021112121221121312
2212123120310311121230212232222
2303022213121231230221123020102
2210220120212222223030222312312
2310313011302202202121222223022
2013021112212312111212222020122
3112113121102210312230222311222
2122122211312121222102302232302
3022303102102212222311031020212
2301030311102323021211302123102
2131121131230220312130231023022
2221121202123011022121223102122
2213023111021121123032102312222
3102102113013021230221112210222
2310311121302130221203110311022
2112212232211231012112311031122
3102302222312221111122223112222
2132310202230231311022302321222
2220211322201202231220210212202
3021230202113110230211211022210
2112121123122131022312123122322
2303023023021212321021212210202
2230112120302122201121102311122
2211121030231122131213110231212
3111212311223203021122211023102
2310222212020112310221112102112
2112121303111122223013302311222
2303022212211220223120231032302
2212110220312111102230223102222
3103111231031112122231022122212
2131221211203121210203122212222
3102122112123012111110221122122
2113010231020313112310231021202
3102131221111022321211223110122
2111102111111100210110202121102
1111111111111111111111111111110
