31113113101111111113111311111112
23102320311311231221231012131122
22112211110232222312221331022122
21122111231022302020230021303222
30301310223100231111203110212222
23213031021121021132212131102222
22122111031211111222231021110222
20221111210131132220103113111022
31213112111230202213110300311122
23102312212202310302112312233022
20110222122312213031122221202122
31112223122222122231202012123222
21301020222102302202111112220202
30311131003122211112311122110312
21013023111202113102212222111102
21312122130213302312302221123122
31021231021300212220312111230212
21112021312132302121221232203122
21321112023220231212212022311022
32031221122212210122303100031022
21210233020122111222030313313102
22031220311221111223121022220322
23102023031233110220231100211202
22331122202202123031211132312112
30222121130323230310331022021122
23023211002022203012223301113022
22300311131020111122022012310322
22233031211113111203222312011022
22002302131210312130021021113122
21122213021111221223131113110222
01230222123121022202201230130222
31023103210211102310131021303022
21223030111311130311221112212102
22220321311031023032111120303122
22211022031303021021113021232102
22311123102223113110230310222312
22033021230210212303103131020302
21122312221111320210310203103012
31022220213032211131031112313102
21102011110300103010301210020302
11111111111111111111111111111110
