1103102012021300223110022213212
2130203223312230233003203301130
0311032122130011001301300312330
2020012020132100120123010203132
0101301133033211020112003120302
0131331222030122212212331133200
0321011202000000122232201220110
0220200321132332132112032101120
2110321302131330333212000130132
1012112331333211122011232012320
2011310220013213110220311023322
1100200323013202212300201303330
2033120120031231311000123322222
2031113310220331011200302101232
1330212102122202311111221010320
0300033311122021003121122000020
2302032311102032220222202222310
3111130233330230322132333313230
3202020323013231031121020200030
0203210001110122123203231223212
1022011322031312010012003223012
3202120323003022111130330331202
3121313033133023010123313123022
0110130032032323203112221300332
3013101110220202001313012020000
1123000003210120202233001033220
1120213332211130022110103200310
1202323100023211101022221000120
0010331223113132010020201132130
3203013320032311330002310013332
1022300313030001310102123220332
0313130233110223012313111023122
2120020020132101130230330122302
1101320033133332221031233133202
0332223221330210200202013300332
0332002030211332031211323032220
2230111202120320311320112203000
3300030103210012113030301000202
1323000210212302132330333322312
2003322030033120003110010303232
3222202203323131131313223023322
1011100111000000010111000001100
