322212001332231011112
002303132032020320310
112020211222212022002
032301220301333112100
222013022330011212030
311321203021122112320
001133313302210322102
000032100310303001222
233020022202113230210
321321112033311123230
111132312132120023030
311020223211223213022
332023120002333223132
113031213301133133322
311303033013023111210
023002223200200222310
022332321002130003030
200013122220303030220
303201020112300303332
131121232101313323010
100000110101100101110
