1332313110023011103330230201000
3123311031011003312132233233200
1303012011222210101321013102330
3330202203113021130213012123332
1210310221323111030103100212230
0033031122013122300222102120230
0030333301003012333133231003132
1321333230121231010233013122120
0221112313333321320110220003330
1021320211302133113000311033322
1222000101222010323100122311302
1102102331302010231320212031132
3201312210301012201133311213312
0310232111313002313130021323230
2022301202111202111331022011202
3000133230212333131031023110222
2103111011101030011001101130322
2303033100232122232320020321122
3023102303121032231031101112012
3121231221200122313022110013132
1301001303002012323302203232222
2110210201210001211211012322132
0122123103311303303100021003032
3332121201132223020011323213212
2331211101233212002011013332130
2331233210222230211102111200032
3011133133201100200323320302120
2033333203102132231332122223002
0033232312011012333010331311210
1102310320201333202320010332302
0222101102131002302333203212100
0320112011311232011223222321120
2123122100031333133110230322302
0212310223231323111303102132332
0132102222010323010011303110300
3301331100211202132302332031012
3302230021323020123012203301200
2311020302220121321320213133022
1333110332302021100102030201230
2313013131211111221330013030212
1100001011100000100100100110100
